################
#**********é***#
#**&****&******#
#************é*#
################